^^^^^^^^^^^&&&&&&&
^^^^^^^^^&&&&&&&&&
^^^^^^^...&&&&&&&&
^^^^^^^^...&&&&&&&
^^^^^^......&&&&&&
~~~^^...^...&&&..&
~~~~~~.......&....
~~~~~~~~..........
~~~~~~~..&&&......
~~~~~..&&&&&..&.&.
~~~~~~.&&&&&&.....
~~~~~...&&&.......
